############################################################
##                         J  I                           ##
##                                                        ##
##                                                        ##
##                                                        ##
##                                                        ##
##                                                        ##
##                                                        ##
##                                                        ##
##                                                        ##
##                                                        ##
##                                                        ##
##                                                        ##
##                                                        ##
##                                                        ##
##                                                        ##
##                                                        ##
##                                                        ##
##                                                        ##
##                                                        ##
##                                                        ##
##                                                        ##
##                                                        ##
##                                                        ##
##                                                        ##
##                                                        ##
##                                                        ##
##                                                        ##
##                                                        ##
############################################################
