############################################################
############################################################
##J                            I                          ##
##                                                        ##
##                                                        ##
##        #         #          #########                  ##
##          #      #           #        #                 ##
##            #   #            #         #                ##
##              #              #         #                ##
##             #  #            #         #                ##
##            #     #          #        #                 ##
##           #       #         ########                   ##
##                                                        ##
##                            I                           ##
##                                                        ##
##                                        #               ##
##                                        #               ##
##                                        #               ##
##                                        #               ##
##                                        #               ##
##                                                        ##
##                                                        ##
##                                                        ##
##                                                        ##
##                                                        ##
##                          #######                       ##
##                                                        ##
##                                                        ##
############################################################
############################################################
