############################################################
############################################################
##J                            I                          ##
##                                                        ##
##                                                        ##
##                                                        ##
##                                                        ##
##                                                        ##
##                                                        ##
##                                                        ##
##                                                        ##
##                                                        ##
##                                                        ##
##                                                        ##
##                                                        ##
##                                                        ##
##                                                        ##
##                                                        ##
##                                                        ##
##                                                        ##
##                                                        ##
##                                                        ##
##                                                        ##
##                                                        ##
##                                                        ##
##                                                        ##
##                                                        ##
##                                                        ##
############################################################
############################################################
